################################################################################
#                                                                              #
#                            C programming Exercise                            #
#                                     0000                                     #
#                                                                              #
################################################################################

Write a program that prints the string "Hello World!".
